NO ./bonus/textures_bonus/wall1.png
SO ./bonus/textures_bonus/wall2.png
WE ./bonus/textures_bonus/wall3.png
EA ./bonus/textures_bonus/wall4.png
HD ./bonus/textures_bonus/door.png

F 0,128,0
C 0,255,255


        1111111111111111111111111
        100H000000110000000000001
        101100000111000000E000001
        1001000000H00000000000001
111111111011000001110000000000001
100000000011000001110111111111111
1111H111111111011100000010001
11110111111111H11101010010001
11000000110101011100000010001
10000000000000001100000010001
10000000000000001101010011111
11000001110101011111011110001
11110111 1110101 101111010001
11111111 1111111 111111111111
